% HEADER START
22,19 % (dimx,dimy)
9,17  % (startx,starty)
EAST  % start orientation
67    % amount of food on the map
% HEADER END
# # # # # # # # # # # # # # # # # # # # # #
# 0 0 0 0 0 # 0 0 0 2 2 2 2 2 0 0 # 2 0 0 #
# 0 0 0 0 0 # 0 0 0 0 0 0 0 2 0 0 # 2 0 0 #
# 0 2 2 4 2 2 2 4 2 2 2 2 0 2 0 0 # 2 0 0 #
# 0 2 0 0 0 # 0 0 0 0 0 2 0 2 2 2 # 4 2 2 #
# 0 4 0 0 0 # 0 0 0 0 0 2 0 0 0 2 # 0 2 0 #
# 0 4 0 0 0 # 0 0 0 0 # 2 2 2 2 2 # 0 4 0 #
# 0 4 0 0 0 # 0 0 0 0 # 0 0 0 0 0 # 0 2 0 #
# 0 2 2 4 0 # 0 0 4 2 2 2 2 4 4 4 2 2 2 0 #
# 0 0 0 2 0 # 0 0 4 0 # 0 0 0 0 0 # 0 2 0 #
# 0 0 0 2 0 # # 0 4 0 # # # # 0 0 # 0 2 0 #
# 0 0 0 4 0 # # 0 2 0 0 0 0 # 0 0 # 2 2 2 #
# 0 0 0 4 0 0 0 0 4 4 2 4 0 # 0 0 # 0 2 0 #
# 0 0 0 2 0 # # 0 0 0 0 4 0 # 0 0 # 0 2 0 #
# 0 0 0 2 0 # # # # # 0 2 0 # 0 0 # 0 2 0 #
# 0 0 0 4 0 0 0 0 0 # 0 2 0 # # # # 2 4 2 #
# 0 0 0 4 2 2 4 2 2 4 4 2 0 0 0 0 # 0 0 0 #
# 0 0 0 0 0 0 0 0 0 # 0 0 0 0 0 0 # 0 0 0 #
# # # # # # # # # # # # # # # # # # # # # #
