% HEADER START
18,18 % (dimx,dimy)
9,16  % (startx,starty)
EAST  % start orientation
44    % amount of food on the map
% HEADER END
# # # # # # # # # # # # # # # # # #
# 0 0 0 0 0 # 0 0 0 2 2 2 2 2 0 0 #
# 0 0 0 0 0 # 0 0 0 0 0 0 0 2 0 0 #
# 0 2 2 4 2 2 2 4 2 2 2 2 0 2 0 0 #
# 0 2 0 0 0 # 0 0 0 0 0 2 0 2 2 2 #
# 0 4 0 0 0 # 0 0 0 0 0 2 0 0 0 2 #
# 0 4 0 0 0 # 0 0 0 0 # 2 2 2 2 2 #
# 0 2 2 4 0 # 0 0 4 2 # 0 0 0 0 0 #
# 0 0 0 2 0 # 0 0 4 0 # 0 0 0 0 0 #
# 0 0 0 2 0 # # 0 4 0 # # # # 0 0 #
# 0 0 0 4 0 # # 0 2 0 0 0 0 # 0 0 #
# 0 0 0 4 0 0 0 0 4 4 2 4 0 # 0 0 #
# 0 0 0 2 0 # # 0 0 0 0 4 0 # 0 0 #
# 0 0 0 2 0 # # # # # 0 2 0 # 0 0 #
# 0 0 0 4 0 0 0 0 0 # 0 2 0 # # # #
# 0 0 0 4 2 2 4 2 2 4 4 2 0 0 0 0 #
# 0 0 0 0 0 0 0 0 0 # 0 0 0 0 0 0 #
# # # # # # # # # # # # # # # # # #
